OOOOOOOOOOOOOOOOOOOOOOOOO
OOOOOOOOOOOOOOOOOOOOOOOOO
OXXXXXXXXXXXXXXXXXXXXXXEO
OXOOOOOOOOOOOOOOOOOOOOOOO
OXXXXXXXXXXXOOOOOOOOOOOOO
OOOOOOOOOOOXOOOOOOOOOOOOO
OOOOOOOOOOOXOOOOOOOOOOOOO
OOOOOOOOOOOSOOOOOOOOOOOOO
OOOOOOOOOOOOOOOOOOOOOOOOO