OOOOOOOOOOOOOOOOOOOOOOOO
OOXXXXXXXXXXXXXXXXXXXXOO
OOXOOOOOOOOOOOOOOOOOOXOO
OOXOOXXXXXXXXXXXEOOOOXOO
OOXOOXOOOOOOOOOOOOOOOXOO
OOXOOXXXXXXXXXXXXXXXXXOO
OOXOOOOOOOOOOOOOOOOOOOOO
OOXXXXXXXXXXXOXXXXXXXSOO
OOOOOOOOOOOOOOOOOOOOOOOO