OOOOOOOOOOOOOOOOOOOOOOOO
OOXXXXXXXXXXXXXXXXXXXXOO
OOXOOOOOOOOOOOOOOOOOOXOO
OOXxxXXXXXXXXXXXEOOOOXOO
OOOOOOOOOOOOOOOOOOOOOXOO
OOOOOOOOOOOOOOOOOOOOOXOO
OOOOOOOOOOOOOOOOOOOOOxOO
OOOOOOOOOOOOOOOOOOOOOSOO
OOOOOOOOOOOOOOOOOOOOOOOO