OOOOOOOOOOOOOOOOOOOOOOOO
OOOOOOOOOOOOOOOOOOOOOOOO
OXXXXXXXXXXXXXXXXXXXXXXE
OXOOOOOOOOOOOOOOOOOOOOOO
OXXXXXXXXXXXOOOOOOOOOOOO
OOOOOOOOOOOXOOOOOOOOOOOO
OOOOOOOOOOOXOOOOOOOOOOOO
OOOOOOOOOOOsOOOOOOOOOOOO
OOOOOOOOOOOOOOOOOOOOOOOO