OOOOOOOOOOOOOOOOOOOOOOOO
OOOOOOOOOOOOOOOOOOOOOOOO
OOXXXXXXXXXXXXXXXXXXXXEO
OOXOOOOOOOOOOOOOOOOOOOOO
OOXXXXXXXXXXOOOOOOOOOOOO
OOOOOOOOOOOXOOOOOOOOOOOO
OOOOOOOOOOOXOOOOOOOOOOOO
OOOOOOOOOOOSOOOOOOOOOOOO
OOOOOOOOOOOOOOOOOOOOOOOO